Avatar|A paraplegic Marine dispatched to the moon Pandora on a unique mission becomes torn between following his orders and protecting the world he feels is his home.|ACTION|ADVENTURE|FANTASY
Back to the Future|Marty McFly, a 17-year-old high school student, is accidentally sent thirty years into the past in a time-traveling DeLorean invented by his close friend, the eccentric scientist Doc Brown.|ADVENTURE|COMEDY|SCIENCE FICTION
Black Panther|T'Challa, heir to the hidden but advanced kingdom of Wakanda, must step forward to lead his people into a new future and confront a challenger from his country's past.|ACTION|ADVENTURE|SCIENCE FICTION
Deadpool|A wisecracking mercenary with accelerated healing powers sets out to track down the man who ruined his face.|ACTION|COMEDY
Finding Nemo|A timid clownfish embarks on a journey to find his son, who has been captured by a diver and placed in a fish tank.|ANIMATION|ADVENTURE|FAMILY
Forrest Gump|A man with a low IQ accomplishes great things in his life, despite facing numerous challenges and setbacks.|COMEDY|DRAMA|ROMANCE
Frozen|When the newly crowned Queen Elsa accidentally uses her power to turn things into ice to curse her home in infinite winter, her sister Anna teams up with a mountain man, his playful reindeer, and a snowman to change the weather condition.|ANIMATION|ADVENTURE|FAMILY
Gladiator|A former Roman General sets out to exact vengeance against the corrupt emperor who murdered his family and sent him into slavery.|ACTION|ADVENTURE|DRAMA
Gone Girl|On the occasion of his fifth wedding anniversary, Nick Dunne reports that his wife, Amy, has gone missing. As the police investigation unfolds, dark secrets are revealed.|CRIME|DRAMA|MYSTERY
Goodfellas|The story of Henry Hill and his life in the mob, covering his relationship with his wife Karen Hill and his mob partners Jimmy Conway and Tommy DeVito in the Italian-American crime syndicate.|BIOGRAPHY|CRIME|DRAMA
Harry Potter and the Sorcerer's Stone|An orphaned boy discovers he's a wizard and begins his education at Hogwarts School of Witchcraft and Wizardry.|ADVENTURE|FAMILY|FANTASY
Inception|A thief who enters the dreams of others to steal their secrets embarks on a complex mission of planting an idea into the mind of a CEO.|ACTION|ADVENTURE|SCIENCE FICTION
Indiana Jones and the Raiders of the Lost Ark|Archaeologist and adventurer Indiana Jones is hired by the U.S. government to find the Ark of the Covenant before the Nazis can obtain its awesome powers.|ACTION|ADVENTURE
Inglourious Basterds|In Nazi-occupied France during World War II, a plan to assassinate Nazi leaders by a group of Jewish U.S. soldiers coincides with a theatre owner's vengeful plans for the same.|ADVENTURE|DRAMA|WAR
Interstellar|A team of explorers travel through a wormhole in space in an attempt to ensure humanity's survival.|ADVENTURE|DRAMA|SCIENCE FICTION
Jaws|When a killer shark unleashes chaos on a beach resort, it's up to a local sheriff, a marine biologist, and an old seafarer to hunt the beast down.|ADVENTURE|THRILLER
Jurassic Park|During a preview tour, a theme park suffers a major power breakdown that allows its cloned dinosaur exhibits to run amok.|ADVENTURE|SCIENCE FICTION|THRILLER
La La Land|A jazz musician and an aspiring actress fall in love in Los Angeles while pursuing their dreams, but their aspirations threaten to tear them apart.|COMEDY|DRAMA|MUSICAL
Mad Max: Fury Road|In a post-apocalyptic wasteland, a woman rebels against a tyrannical ruler in search of her homeland with the help of a group of female prisoners, a psychotic worshiper, and a drifter named Max.|ACTION|ADVENTURE|SCIENCE FICTION
Pirates of the Caribbean: The Curse of the Black Pearl|A blacksmith teams up with an eccentric pirate to rescue the woman he loves from a cursed crew of undead pirates.|ACTION|ADVENTURE|FANTASY
Planet Earth|A groundbreaking documentary series that explores the wonders of the natural world and the various ecosystems that inhabit our planet.|DOCUMENTARY
Ratatouille|A rat who can cook makes an unusual alliance with a young kitchen worker at a famous restaurant.|ANIMATION|COMEDY|FAMILY
Schindler's List|In German-occupied Poland during World War II, industrialist Oskar Schindler gradually becomes concerned for his Jewish workforce after witnessing their persecution by the Nazis.|BIOGRAPHY|DRAMA|HISTORY
Shrek|A mean lord exiles fairytale creatures to the swamp of a grumpy ogre, who must go on a quest and rescue a princess for the lord in order to get his land back.|ANIMATION|ADVENTURE|COMEDY
Spirited Away|During her family's move to the suburbs, a young girl finds herself trapped in a mysterious, magical world populated by spirits and creatures.|ANIMATION|ADVENTURE|FAMILY
The Avengers|Earth's mightiest heroes must come together and learn to fight as a team if they are to stop the mischievous Loki and his alien army from enslaving humanity.|ACTION|ADVENTURE|SCIENCE FICTION
The Dark Knight|When the menace known as the Joker wreaks havoc and chaos on the people of Gotham, Batman must accept one of the greatest psychological and physical tests of his ability to fight injustice.|ACTION|CRIME|DRAMA
The Departed|An undercover cop and a mole in the police attempt to identify each other while infiltrating an Irish gang in Boston.|CRIME|DRAMA|THRILLER
The Departed|An undercover cop and a mole in the police attempt to identify each other while infiltrating an Irish gang in Boston.|CRIME|DRAMA|THRILLER
The Godfather Part II|The early life and career of Vito Corleone in 1920s New York City is portrayed, while his son, Michael, expands and tightens his grip on the family crime syndicate.|CRIME|DRAMA
The Godfather|The aging patriarch of an organized crime dynasty transfers control of his clandestine empire to his reluctant son.|CRIME|DRAMA
The Grand Budapest Hotel|The adventures of Gustave H, a legendary concierge at a famous European hotel between the wars, and Zero Moustafa, the lobby boy who becomes his most trusted friend.|COMEDY|DRAMA
The Green Mile|The lives of guards on Death Row are affected by one of their charges: a black man accused of child murder and rape, yet who has a mysterious gift.|CRIME|DRAMA|FANTASY
The Hunger Games|In a dystopian future, a young woman volunteers to take her sister's place in a brutal televised competition where teenagers fight to the death.|ACTION|ADVENTURE|SCIENCE FICTION
The Incredibles|A family of undercover superheroes, while trying to live the quiet suburban life, are forced into action to save the world.|ANIMATION|ACTION|ADVENTURE
The Intouchables|After he becomes a quadriplegic from a paragliding accident, an aristocrat hires a young man from the projects to be his caregiver.|BIOGRAPHY|COMEDY|DRAMA
The Lion King|A young lion prince flees his kingdom only to learn the true meaning of responsibility and bravery.|ANIMATION|ADVENTURE|DRAMA
The Lord of the Rings: The Fellowship of the Ring|A young hobbit, Frodo Baggins, embarks on a perilous journey to destroy a powerful ring and save Middle-earth from the dark lord Sauron.|ADVENTURE|FANTASY
The Martian|An astronaut is presumed dead and left behind on Mars. He must then use his ingenuity to survive and find a way to signal to Earth that he is alive.|ADVENTURE|DRAMA|SCIENCE FICTION
The Matrix Reloaded|Neo and the rebel leaders estimate that they have 72 hours until Zion falls while the Machines prepare to eradicate humanity.|ACTION|SCIENCE FICTION
The Matrix|A computer hacker learns from mysterious rebels about the true nature of his reality and his role in the war against its controllers.|ACTION|SCIENCE FICTION
The Notebook|A poor yet passionate young man falls in love with a rich young woman, giving her a sense of freedom, but they are soon separated by their social differences.|DRAMA|ROMANCE
The Prestige|After a tragic accident, two stage magicians engage in a battle to create the ultimate illusion while sacrificing everything they have to outwit each other.|DRAMA|MYSTERY|SCIENCE FICTION
The Princess Bride|While home sick in bed, a young boy's grandfather reads him the story of a farmboy-turned-pirate who encounters numerous obstacles, enemies, and allies in his quest to be reunited with his true love.|ADVENTURE|FAMILY|FANTASY
The Revenant|A frontiersman on a fur trading expedition in the 1820s fights for survival after being mauled by a bear and left for dead by members of his own hunting team.|ADVENTURE|DRAMA|THRILLER
The Shawshank Redemption|Two imprisoned men bond over a number of years, finding solace and eventual redemption through acts of common decency.|DRAMA
The Shining|A family heads to an isolated hotel for the winter where an evil spiritual presence influences the father into violence, while his psychic son sees horrific forebodings from both past and future.|DRAMA|HORROR
The Silence of the Lambs|A young FBI cadet must receive the help of an incarcerated and manipulative cannibal killer to help catch another serial killer, a madman who skins his victims.|CRIME|DRAMA|THRILLER
The Sixth Sense|A boy who communicates with spirits seeks the help of a disheartened child psychologist.|DRAMA|MYSTERY|THRILLER
The Social Network|A dramatized account of the founding of Facebook, focusing on the betrayal and legal battles that followed.|BIOGRAPHY|DRAMA
The Sound of Music|A woman leaves an Austrian convent to become a governess to the children of a Naval officer widower.|BIOGRAPHY|DRAMA|FAMILY
The Terminator|A human soldier is sent from 2029 to 1984 to stop an almost indestructible cyborg killing machine, sent from the same year, which has been programmed to execute a young woman whose unborn son is the key to humanity's future salvation.|ACTION|SCIENCE FICTION
The Truman Show|An insurance salesman discovers his whole life is actually a reality TV show.|COMEDY|DRAMA|SCIENCE FICTION
The Truman Show|An insurance salesman discovers his whole life is actually a reality TV show.|COMEDY|DRAMA|SCIENCE FICTION
The Usual Suspects|A sole survivor tells of the twisty events leading up to a horrific gun battle on a boat, which began when five criminals met at a seemingly random police lineup.|CRIME|MYSTERY|THRILLER
Titanic|A seventeen-year-old aristocrat falls in love with a kind but poor artist aboard the luxurious, ill-fated R.M.S. Titanic.|DRAMA|ROMANCE
Toy Story|The toys belonging to a young boy come to life whenever he's not around, leading to a whirlwind of adventure and self-discovery.|ANIMATION|COMEDY|FAMILY